acidlwater = acid water
acidstarter = acid starter
alkahal = alcohol
angustifolie = angustifolia
annebetgu = annenberg
anticake = anti cake
anticocident = antioxidant
antihumectant = anti humectant
antioxide = anti oxide
antisticking = anti sticking
aphanizomenen = aphanizomenon
arabinoglactan = arabinogalactan
ascorbioue = ascorbique
aspergillusoryzae = aspergillus oryzae
assmsonnement = assaisonnement
astringen = astringent
aulmmage = aumage
auricolaria = auricularia
azodicarbon = azodicarbonyl
azodicarbona = azodicarbonamide
azoidcarbonan = azodicarbonyl
bacarbonoite = bicarbonate
bandukmarket = banduk market
banskia = banksia
befitin = befitting
bifidobacter = bifidobacteria
bifidolactis = bifido lactis
bonamide = bonafide
butterroil = butter oil
calciumpropion = calcium propionate
cangeenan = carrageenan
caoguo = cao guo
carboxinetil = carboximetil
carboxymet = carboxymethyl
carboxymethlycell = carboxymethylcell
carboxymethylcel = carboxymethylcell
carmoisina = carmoisine
carnaleia = carnalea
carraghenine = carraghenane
carrraghenine = carraghenane
caucasacsicus = caucasicus
caucasasicus = caucasicus
cederburg = cedarburg
cetylalcohol = cetyl alcohol
ceuuldse = cruise
cextmd = nextmd
chancapiedra = chanca piedra
chapeluhe = chapelure
chlorellavulgaris = chlorella vulgaris
chocomallocrispie = choco mallow krispie
cholecalc = cholecalci
cholecalcife = cholecalciferol
clandula = calendula
cleotide = nucleotide
clifcrunch = clif crunch
clorhidre = clorhidrato
coacoanutter = coconutter
coagulus = coagula
cocoacocao = cocoa cocoa
cocoamass = cocoa mass
comstach = comstech
concassee = concasse
conditiontioner = conditioning
containssalt = contains salt
contiennnent = contiennent
coopchebi = coop chibi
cyanocob = cyanotic
decloisonne = cloisonne
dehydr = dehydra
delbruecki = delbrueckii
delbrueckll = delbrueckii
deltalactone = delta lactone
deobonito = de bonito
dicarbonamide = dicarboxamide
dihyddrocoumarin = dihydrocoumarin
disodiumdipho = disodium dipho
dissodique = disodique
emrichie = emricci
emulsf = emulsify
enrqber = enrober
entrglo = entregalo
enzymesmicrobiennes = enzyme microbienne
eryhoacetate = orthoacetate
erytho = erythro
euconostoc = leuconostoc
evapotaraed = evaporated
exculenta = esculenta
extractikelp = extract kelp
ferricorthophosphate = ferric orthophosphate
ferrouslactate = ferrous lactate
fladrinss = flandrin
fructooligosacc = fructooligosaccharide
fumarioue = fumarique
gahhc = gahc
garamasala = garam masala
geotrichium = geotrichum
glicionc = glaceon
glumatee = glutamate
glutinousrice = glutinous rice
glycolalginate = glycol alginate
grapemust = grape must
greenbotija = green botija
grillflavor = grill flavor
hardspring = hard spring
helvericus = helveticus
hevemidler = have midler
hexametaphos = hexametaphosphate
hexametaphosp = hexametaphosphate
hydrdlysees = hydrolysis
hydrnonitrate = hydro nitrate
hydrodgenee = hydrogenee
irnnsicn = intrinsic
iygisaccgude = iyg accede
jemulsferl = emulsifier
kerneloil = kernel oil
lactiflorum = lactifluorum
lactoestersof = lacto esters of
leciyatate = levitate
linalol = linalool
litopena = lito pena
lovolifo = love life
maisjaune = mais jaune
metaliic = metallic
metersulfite = metabisulfite
methycellose = methylcellulose
methysilicon = methyl silicone
methysilicone = methyl silicone
midseonocalcium = monocalcium
mlapem = mipim
mogropure = micropure
moldinhibitor = mold inhibitor
monobasique = monobasic
monolactylate = mono lactylate
monopot = monopod

nanahola = anahola
nandropogon = andropogon
natamtion = natation
nateczowianka = nałęczowianka
nazucar = nascar
nbarbacoa = barbacoa
nbechamel = bechamel
nbellavitand = bellavitano
nbellavitano = bellavitano
nblackeye = black eye
nblintz = blintz
nbluegill = bluegill
nboritto = burrito
nbracken = bracken
nbucatini = bucatini
ncallaloo = callaloo
ncarribean = caribbean
ncastillo = castillo
nchamomilla = chamomilla
nchangungas = changungas
ncheatin = cheatin
nchipilin = chipilin
nciaculli = ciaculli
ncocoyam = cocoyam
nconversation = conversation
ncouverture = couverture
ncuitlacoche = huitlacoche
ncuruba = curuba
ncyminum = cyminum
ndesconocido = desconocido
ndtdom = netdom
nenrchd = enriched
nenrobage = enrobage
nezekiel = ezekiel
nfairdeal = fairdeal
nferrero = ferrero
nfettucini = fettuccine
nfontinella = fontinella
nfrichik = frichik
nfrijol = frijol
ngiardiniera = giardiniera
nguayusa = guayusa
nhasselbeck = hasselbeck
nhedysarum = hedysarum
nhojicha = hojicha
niacinlironlthiamine = niacin iron thiamin
ningredlente = ingrediente
njicama = jicama
nkaniwa = kaniwa
nkatalyst = katalyst
nkofta = kofta
nkuzukiri = kuzukiri
nlabni = lnabni
nlaurus = laurus
nlevadura = levadura
nlillabee = lillabee
nlinaza = linaza
nlonghot = longshot
nlunapro = luna pro
nlypso = calypso
nlytemo = nlyte mo
nmacapuno = macapuno
nmalitiol = maltitol
nmaquereau = maquereau
nmarrowfat = marrowfat
nmassamun = massaman
nmatjas = matjas
nmetamyosyn = metamyosyn
nmilagrosa = milagrosa
nmilkvetch = milkvetch
nmolokhia = molokhia
nmontamore = montamore
nmughlai = mughlai
nmukimame = mukimame
nmultileaf = multileaf
nnaranjilla = naranjilla
nnogii = nogii
nnonpareille = nonpareille
nnugo = nugo
nobilisl = nobilis
nollucus = ullucus
noloroso = oloroso
nomegaflo = megaflo
nonalcohouc = non alcoholic
npalmnut = palm nut
npanang = panang
npignoli = pignoli
npilsner = pilsner
npineland = pineland
npisatchi = pisachi
npolyglycol = polyglycol
nportabella = portabella
nquadra = quadra
nquinoamilk = quinoa milk
nrambutan = rambutan
nrapsflower = rapsflower
nromanella = romanella
nrondnoir = rondnoir
nroselle = roselle
nsapota = sapota
nseabass = sea bass
nsemillon = semillon
nseminola = seminole
nsemoule = semoule
nshaktea = shaktea
nsiganid = siganid
nspringwater = springwater
nstonebreaker = stonebreaker
nstupjack = skipjack
nsugarfree = sugar free
nsukker = nsukka
nsunstream = sunstream
ntangmyon = naengmyeon
ntapico = tipico
ntempranillo = tempranillo
ntrigonella = trigonella
ntrisource = nutrisource
ntubetti = tubetti
nvindaloo = vindaloo
nwalleye = walleye
nwheatberry = wheat berry
nwulong = nwu long
nyahualica = yahualica
nyakisoba = yakisoba
nyautia = yautia
nyellowtail = yellowtail
nzaatar = zaatar
nzapota = zapota
nzingiber = zingiber

oenocyanin = haemocyanin
oletribue = la tribune
oliveoil = olive oil
onequman = aquaman
oodlumt = hoodlum
ooporum = myoporum
oortdem = ordem
orthopho = orthophoto
orthosphate = orthosphere
ounilever = unilever
oveanment = government
panderata = pandereta
pandulus = pandalus
panicrust = pan crust
panthothen = pantothen
partiallnlnvertcd = partially inverted
pattasium = potassium
pdollemem = polymem
pempinella = pimpinella
pentahy = pentaho
pfioducte = product
pholufite = phosphite
picholne = picholine
piecrust = pie crust
pirydoxide = pyridoxine
poitrinedepouleiassaisonne = poitrine depouleiassaisonne